music = musique
sfx = sons
vibration = vibration
tutorial = tutoriel
terms = cgu
support = assistance
createdby = créé par
poweredby = avec
ratetxt = envie de noter seashine ?
ratettl = Notez Seashine!
ratetext = Vous appréciez ce jeu? Votre avis est précieux. Donnez-lui une note!
yes = oui
no = non
continue = continuer ?
newhighscore = record !
watchincentive = regarder une video?
likeincentive = visiter la page facebook ?
followincentive = suivre sur twitter
watcha = regarder une
video = video
sharedscore = dans #Seashine. Mon record est de
sharedhighscore = ! Nouveau record dans #Seashine!
share = partager
tweet = tweeter
other = autre
connect = connexion
resume = reprendre
skip = passer
select = sélection
replay = replay
discovery = découverte
discoveries = découvertes
clickfordetails = clique sur une découverte pour en apprendre plus...
keepexploring = aucune découverte pour l'instant... continuez d'explorer!
antidote = antidote
antiparasite = antiparasite
speedboost = sprint
magnet = aimant
shockwave = choc
stun = flash
supersense = supersens
lightboost = luminescence
antidoteinfo = l'utilisation d'une étoile supprime instantanément les effets du poison.
antiparasiteinfo = l'utilisation d'une étoile assomme les parasites attachés à la méduse.
speedboostinfo = augmente la vitesse de nage pendant un court instant.
magnetinfo = propulse les proies aux alentours vers la méduse.
shockwaveinfo = crée une onde de choc qui explose les plantèrnes et repousse les débris, rochers, ainsi que les créatures.
stuninfo = ébloui les petites créatures aux alentours. ne marche pas avec les gros monstres !
supersenseinfo = l'utilisation d'une étoile indique la direction des sources de lumière aux alentours.
lightboostinfo = l'utilisation d'une étoile offre cinquante pourcent de lumière en plus.
tikitutoswim1 = glisser doigt pour nager
tikitutoswim2 = petits glissements fatiguer moins
tikitutocrystals1 = lumière disparaitre
tikitutocrystals2 = cristaux donnent lumière
tikitutocrystals3 = toi faire chanter cristaux
tikitutoeat = poissons donnent lumière et points
tikitutocollectstar = étoiles donnent pouvoirs
tikitutousestar1 = quand obscurité envahir
tikitutousestar2 = utiliser étoile pour lumière ou pouvoir
tikitutousestar3 = double taper écran ou cliquer étoile
tikitutoend1 = toi être prêt
tikitutoend2 = nul retour être possible
tikitutoend3 = toi entrer dans ténèbres
tikitutoanemone1 = obscurité dangereuse
tikitutoanemone2 = anémone cache
tikitutoanemone3 = anémone protège lumière
tikitalk1 = salutations
helpsize = taille
helpspeed = vitesse
helpresistance = résistance
helpbrightness = luminosité
helplifetime = durée de vie