music = 음악
sfx = 음향 효과
vibration = 촉각 효과
tutorial = 튜토리얼
ratetxt = SEASHINE 평가
newhighscore = 새로운 최고 점수!
likeincentive = 페이스북에서 좋아요를 눌러 주십시오
followincentive = 트위터에서 팔로우하기
watcha = 
video = 동영상보기
sharedscore = on #Seashine. My top is
sharedhighscore = ! #Seashine 신기록! seashinegame.com
share = 공유하기
tweet = 트위터
other = 다른
connect = 로그인
resume = 다시 차지하다
select = 고르다
replay = 리플레이
discovery = discovery
discoveries = discoveries
clickfordetails = click on a discovery to learn more about it...
keepexploring = no discovery... keep exploring.
antidote = 해독제
antiparasite = 구충제
speedboost = 가속
magnet = 자석
shockwave = 충격파
stun = 섬광
supersense = 직관
lightboost = 발광
antidoteinfo = using a star instantly cures poison.
antiparasiteinfo = using a star stuns the parasites attached to your body.
speedboostinfo = increases your swim speed for a short moment.
magnetinfo = drags nearby preys towards you.
shockwaveinfo = creates a shockwave breaking plantern bulbs and pushing away any debris, rock, or creature.
stuninfo = using a star stuns the small creatures nearby. but it does not work on big monsters!
supersenseinfo = using a star gives the direction of surrounding light sources.
lightboostinfo = the use of a star gives fifty percent more light.
tikitutoswim1 = 이동 손가락을 밀어\n넣습니다
tikitutoswim2 = 작은 제스처를 덜\n피로합니다
tikitutocrystals1 = 당신의 빛이 퇴색된다
tikitutocrystals2 = 수정 당신의 에너지를\n다시 생성
tikitutoeat = 물고기는 빛과\n포인트를 제공합니다
tikitutocollectstar = 별은 특정 권한을\n제공합니다
tikitutousestar1 = 때 어둠이 온다
tikitutousestar2 = 당신의 별을\n사용합니다
tikitutousestar3 = 화면의 아무 곳이나 두 번 누릅니다
tikitutoend1 = 당신은 준비가되어\n있습니다
tikitutoend2 = 다시는 돌이킬 수\n없습니다
tikitutoend3 = 어둠을 입력합니다
tikitutoanemone1 = 어둠은 위험이\n가득합니다
tikitutoanemone2 = 아네모네는 좋은\n숨어 있습니다
tikitutoanemone3 = 말미잘 당신을\n보호합니다
tikitalk1 = 여보세요
helpsize = 크기
helpspeed = 속도
helpresistance = 보호
helpbrightness = 광채
helplifetime = 수명