music = música
sfx = efeitos  sonoros
vibration = efeitos táteis
tutorial = tutorial
terms = cgu
support = assistência
createdby = criado por
poweredby = com
ratetxt = gostou deste jogo? avalie seashine!
ratettl = Avalie Seashine
ratetext = Gostou deste jogo? O seu feedback é precioso. Atribua-lhe uma classificação!
yes = Sim
no = Não, obrigado!
later = Lembrar-me mais tarde
newhighscore = novo recorde!
watchincentive = visualize um vídeo e ganhe estrelas
likeincentive = gostar no facebook
followincentive = seguir no twitter
watcha = visualizar  um
video = vídeo
sharedscore = on #Seashine. My top is
sharedhighscore = ! Nova pontuação máx no #Seashine!
share = share
tweet = tweet
other = outros
connect = entrar
resume = resumo
skip = deixar
select = seleção
replay = replay
discovery = descoberta
discoveries = descobertas
clickfordetails = clique em uma descoberta para mais informações...
keepexploring = nenhuma descoberta ainda... continuar a explorar!
antidote = antídoto
antiparasite = antiparasita
speedboost = velocidade
magnet = ímã
shockwave = choque
stun = atordoar
supersense = supersenso
lightboost = brilho
antidoteinfo = a utilização de uma estrela remove instantaneamente os efeitos do veneno.
antiparasiteinfo = o uso de uma estrela atordoa parasitas ligados ao água-viva.
speedboostinfo = aumenta a velocidade de natação para um curto período de tempo.
magnetinfo = atrai a presa nas proximidades.
shockwaveinfo = cria uma onda de choque que sopra as planternas e repele detritos, pedras e criaturas.
stuninfo = deslumbra as pequenas criaturas ao redor. não funciona com grandes monstros !
supersenseinfo = o uso de uma estrela indica a direção das fontes de luz na área.
lightboostinfo = o uso de uma estrela proporciona cinquenta por cento mais luz.
tikitutoswim1 = deslize o dedo para nadar
tikitutoswim2 = pequeno deslize para menos fadiga
tikitutocrystals1 = luz está desaparecendo
tikitutocrystals2 = tocar cristais dá luz
tikitutocrystals3 = fazer cristais cantar
tikitutoeat = peixe dá luz e pontos
tikitutocollectstar = estrelas dão poderes
tikitutousestar1 = quando a escuridão vem
tikitutousestar2 = use estrela para luz ou poderes
tikitutousestar3 = duplo toque tela ou clique estrela
tikitutoend1 = tu estás pronto
tikitutoend2 = não tem volta
tikitutoend3 = entrar na escuridão
tikitutoanemone1 = escuridão cheia de perigos
tikitutoanemone2 = anêmona esconde
tikitutoanemone3 = anêmona protege a luz
tikitalk1 = cumprimentos
helpsize = tamanho
helpspeed = velocidade
helpresistance = resistência
helpbrightness = brilho
helplifetime = vida