music = 音乐
sfx = 音响效果
vibration = 触觉反馈效果
tutorial = 教程
terms = 一般的使用条件
support = 协助
createdby = 创造者
poweredby =
ratetxt = 记住SEASHINE!
newhighscore = 新纪录!
watchincentive = 观看视频并赢得星星
likeincentive = 分享到FACEBOOK
followincentive = 分享到TWITTER
watcha = 
video = 观看视频
sharedscore = 是我的记录。 #Seashine seashinegame.com
sharedhighscore = ！ 新纪录！ #Seashine seashinegame.com
share = 分享
tweet = 鸣叫
other = 其他
connect = 连接
resume = 继续
replay = 重播
select = 选择
discovery = discovery
discoveries = discoveries
clickfordetails = click on a discovery to learn more about it...
keepexploring = no discovery... keep exploring.
antidote = 解药
antiparasite = 驱虫
speedboost = 速度
magnet = 磁铁
shockwave = 冲击波
stun = 休克
supersense = 直觉
lightboost = 发光
antidoteinfo = using a star instantly cures poison.
antiparasiteinfo = using a star stuns the parasites attached to your body.
speedboostinfo = increases your swim speed for a short moment.
magnetinfo = drags nearby preys towards you.
shockwaveinfo = creates a shockwave breaking plantern bulbs and pushing away any debris, rock, or creature.
stuninfo = using a star stuns the small creatures nearby. but it does not work on big monsters!
supersenseinfo = using a star gives the direction of surrounding light sources.
lightboostinfo = the use of a star gives fifty percent more light.
tikitutoswim1 = 滑动手指游泳
tikitutoswim2 = 一个小手势不太累人
tikitutocrystals1 = 你的能量正在减弱
tikitutocrystals2 = 该晶体恢复你的能量
tikitutoeat = 吃鱼就发出亮光
tikitutocollectstar = 星可以帮助您\n或您节省
tikitutousestar1 = 当黑暗降临
tikitutousestar2 = 用你的明星
tikitutousestar3 = 双击任何地方或\n点击的明星
tikitutoend1 = 你准备好了
tikitutoend2 = 没有回报是可能的
tikitutoend3 = 你要进入黑暗
tikitutoanemone1 = 黑暗充满了危险
tikitutoanemone2 = 躲在海葵
tikitutoanemone3 = 这海葵保护你
tikitalk1 = 你好
helpsize = 尺寸
helpspeed = 速度
helpresistance = 结实
helpbrightness = 亮度
helplifetime = 寿命