music = musik
sfx = soundeffekte
vibration = haptische effekte
tutorial = tutorial
terms = agb
support = support
createdby = erstellt von
poweredby = mit
ratetxt = notiere den spiel?
ratettl = Notiere den Seashine
ratetext = Gefällt dir dieses Spiel? Deine Meinung ist wertvoll. Gebe eine Bewertung ab!
yes = Einverstanden
no = Nein, danke!
later = Später erneut erinnern
newhighscore = neuer rekord!
watchincentive = ein video ansehen und sterne verdienen
likeincentive = auf facebook ein like geben
followincentive = folge uns auf twitter
watcha = ein video
video = ansehen
sharedscore = ist mein Rekord. #Seashine seashinegame.com
sharedhighscore = ! Neuer Top bei #Seashine. seashinegame.com
share = share
tweet = tweet
other = other
connect = verbindung
resume = resume
skip = verlassen
select = auswählen
replay = replay
discovery = discovery
discoveries = discoveries
clickfordetails = click on a discovery to learn more about it...
keepexploring = no discovery... keep exploring.
antidote = gegenmittel
antiparasite = antiparasite
speedboost = sprint
magnet = magnet
shockwave = schockwelle
stun = blenden
supersense = supersense
lightboost = lumineszenz
antidoteinfo = using a star instantly cures poison.
antiparasiteinfo = using a star stuns the parasites attached to your body.
speedboostinfo = increases your swim speed for a short moment.
magnetinfo = drags nearby preys towards you.
shockwaveinfo = creates a shockwave breaking plantern bulbs and pushing away any debris, rock, or creature.
stuninfo = using a star stuns the small creatures nearby. but it does not work on big monsters!
supersenseinfo = using a star gives the direction of surrounding light sources.
lightboostinfo = the use of a star gives fifty percent more light.
tikitutoswim1 = schieben finger zu schwimmen
tikitutoswim2 = eine kleine geste ist weniger anstrengend
tikitutocrystals1 = ihr licht verschwindet
tikitutocrystals2 = kristalle geben ihnen licht
tikitutoeat = fische geben licht und punkte
tikitutocollectstar = sterne geben macht
tikitutousestar1 = wenn die dunkelheit herrscht
tikitutousestar2 = verwenden sie einen stern für licht oder macht
tikitutousestar3 = tippen sie doppelt überall oder klicken sie auf den stern
tikitutoend1 = sie sind bereit
tikitutoend2 = keine rückkehr ist möglich
tikitutoend3 = treten sie ein in die dunkelheit
tikitutoanemone1 = dunkelheit ist voller gefahren
tikitutoanemone2 = sie können in anemonen verstecken
tikitutoanemone3 = die anemone schützt ihr licht
tikitalk1 = hallo
helpsize = größe
helpspeed = geschwindigkeit
helpresistance = widerstandsfähigkeit
helpbrightness = helligkeit
helplifetime = lebensdauer