music = musica
sfx = effetti sonori
vibration = effetti tattily
tutorial = tutorial
terms = t.c.u.
support = assistenza
createdby = creato da
poweredby = powered by
ratetxt = ti andrebbe di dare un voto al gioco?
ratettl = Votare questo gioco
ratetext = Ti andrebbe di dare un voto al gioco?
yes = Si
no = No
later = Ricordamelo più tardi
newhighscore = nuovo record!
watchincentive = guarda un video e ottieni delle stelle
likeincentive = metti mi piace su facebook
followincentive = segui su twitter
watcha = guarda un
video = video
sharedscore = on #Seashine. My top is
sharedhighscore = ! New top score on #Seashine.
share = condividere
tweet = tweet
other = altro
connect = accedi
resume = continuare
skip = lasciare
select = selezione
replay = replay
discovery = scoperta
discoveries = scoperte
clickfordetails = clicca su una scoperta per ulteriori informazioni...
keepexploring = nessuna scoperta ancora... continuiamo a esplorare.
antidote = antidoto
antiparasite = antiparassita
speedboost = sprint
magnet = magnete
shockwave = onda d'urto
stun = flash
supersense = supersenso
lightboost = luminescenza
antidoteinfo = l'uso di una stella rimuove istantaneamente gli effetti del veleno.
antiparasiteinfo = l'uso di una stella stordisce parassiti attaccati alla medusa.
speedboostinfo = aumenta la velocità di nuoto per un breve periodo.
magnetinfo = attrae rapidamente preda vicino.
shockwaveinfo = crea un'onda d'urto che soffia le planterne e respinge detriti, rocce e creature.
stuninfo = abbaglia le piccole creature vicine. non funziona con i grandi mostri!
supersenseinfo = l'uso di una stella indica la direzione delle sorgenti luminose nella zona.
lightboostinfo = l'uso di una stella fornisce cinquanta per cento più luce.
tikitutoswim1 = far scorrere il dito per muoversi
tikitutoswim2 = piccolo slittamento per meno fatica
tikitutocrystals1 = la tua luce si esaurisce
tikitutocrystals2 = cristalli danno energia
tikitutocrystals3 = fanno cristalli cantare
tikitutoeat = pesce dà luce e punti
tikitutocollectstar = stelle danno poteri
tikitutousestar1 = quando il buio arriva
tikitutousestar2 = utilizzare stella per luce o poteri
tikitutousestar3 = doppio tap schermo o fare clic stella
tikitutoend1 = sei pronto
tikitutoend2 = non si torna indietro
tikitutoend3 = entrare nel buio
tikitutoanemone1 = buio pieno di pericoli
tikitutoanemone2 = anemone nasconde
tikitutoanemone3 = anemone protegge la luce
tikitalk1 = ciao
helpsize = dimensione
helpspeed = velocità
helpresistance = resistenza
helpbrightness = luminosità
helplifetime = vita