music = 音楽
sfx = 音響効果
vibration = 触感フィードバック
tutorial = チュートリアル
terms = 一般使用条件
support = サポート
createdby = 製作
poweredby = とともに
ratetxt = SEASHINE を評価してください！
newhighscore = 新記録です!
likeincentive = FACEBOOK でいいね！する
followincentive = TWITTER でフォローする
watcha = 
video = 動画を見る
sharedscore = は私の記録です。 #Seashine seashinegame.com
sharedhighscore = ! #Seashine の新最高点。 seashinegame.com
share = シェア
tweet = ツイート
other = もっと
connect = ログイン
resume = 再開する
select = 選び出す
replay = リプレイ
discovery = discovery
discoveries = discoveries
clickfordetails = click on a discovery to learn more about it...
keepexploring = no discovery... keep exploring.
antidote = ワクチン
antiparasite = 寄生虫駆除剤
speedboost = 速度
magnet = 磁石
shockwave = 衝撃波
stun = グレア
supersense = 第六感
lightboost = 発光
antidoteinfo = using a star instantly cures poison.
antiparasiteinfo = using a star stuns the parasites attached to your body.
speedboostinfo = increases your swim speed for a short moment.
magnetinfo = drags nearby preys towards you.
shockwaveinfo = creates a shockwave breaking plantern bulbs and pushing away any debris, rock, or creature.
stuninfo = using a star stuns the small creatures nearby. but it does not work on big monsters!
supersenseinfo = using a star gives the direction of surrounding light sources.
lightboostinfo = the use of a star gives fifty percent more light.
tikitutoswim1 = 泳ぐこと指をスライド\nさせます
tikitutoswim2 = 小さなジェスチャー\n疲れにくいです
tikitutocrystals1 = あなたの光が\n退色されます
tikitutocrystals2 = 結晶はあなたが\n点灯与えます
tikitutoeat = 魚は光とポイント\nを与えます
tikitutocollectstar = 星は特別な力を\n与えます
tikitutousestar1 = とき暗闇が来ます
tikitutousestar2 = 輝くためにあなたの星\n使用してください
tikitutousestar3 = どこでもダブルタップ
tikitutoend1 = あなたは準備が\nできています
tikitutoend2 = 後戻りできない
tikitutoend3 = 闇へのステップ
tikitutoanemone1 = 闇は危険が\nいっぱいです
tikitutoanemone2 = アネモネは良い\n隠れ家です
tikitutoanemone3 = アネモネはあなたを\n守ります
tikitalk1 = こんにちは
helpsize = サイズ
helpspeed = 速度
helpresistance = 頑丈な
helpbrightness = 明るさ
helplifetime = 寿命