music = música
sfx = efectos sonoros
vibration = efectos táctiles
tutorial = tutorial
terms = t.c.u.
support = ayuda
createdby = creado por
poweredby = con
ratetxt = ¿hacer un comentario del juego?
ratettl = Como este juego?
ratetext = ¿Nos puntuas y haces un comentario del juego?
yes = Sí!
no = No, ¡gracias!
later = Recordar más tarde
newhighscore = nuevo récord!
watchincentive = mira un vídeo y gana estrellas
likeincentive = me gusta en facebook
followincentive = sigue en twitter
watcha = mira un
video = video
sharedscore = en #Seashine. Mi máx es
sharedhighscore = ! Nuevo puntaje máximo en #Seashine.
share = compartir
tweet = tweet
other = otro
connect = inicia sesión
resume = continuar
skip = dejar
select = selección
replay = replay
discovery = descubrimiento
discoveries = descubrimientos
clickfordetails = haga clic en un descubrimiento para aprender más acerca de él...
keepexploring = ningún descubrimiento... continuar explorando.
antidote = antídoto
antiparasite = antiparásito
speedboost = aceleración
magnet = imán
shockwave = choque
stun = flash
supersense = supersentido
lightboost = luminiscencia
antidoteinfo = el uso de una estrella elimina al instante los efectos del veneno.
antiparasiteinfo = el uso de una estrella aturde los parásitos pegados a la medusa.
speedboostinfo = aumenta la velocidad de natación por un corto tiempo.
magnetinfo = arrastra presas cercanas hacia usted.
shockwaveinfo = crea una onda de choque que rompe las planternas y repele escombros, rocas y criaturas.
stuninfo = deslumbra las pequenas criaturas cercanas. no funciona con grandes monstruos.
supersenseinfo = el uso de una estrella indica la dirección de las fuentes de luz en la zona.
lightboostinfo = el uso de una estrella ofrece cincuenta por ciento más de luz.
tikitutoswim1 = deslice dedo para nadar
tikitutoswim2 = pequeno deslizamiento para menos fatiga
tikitutocrystals1 = su luz se desvanecía
tikitutocrystals2 = cristales regeneran luz
tikitutocrystals3 = hacen cristales cantan
tikitutoeat = peces dan luz y puntos
tikitutocollectstar = estrellas dan poderes
tikitutousestar1 = cuando llega la oscuridad
tikitutousestar2 = usar estrella para luz o poderes
tikitutousestar3 = doble toque pantalla o clic estrella
tikitutoend1 = estas listo
tikitutoend2 = no hay vuelta atrás
tikitutoend3 = entrar en la oscuridad
tikitutoanemone1 = oscuridad llena de peligros
tikitutoanemone2 = anémona esconde
tikitutoanemone3 = anémona protege la luz
tikitalk1 = saludos
helpsize = tamaño
helpspeed = velocidad
helpresistance = resistencia
helpbrightness = brillo
helplifetime = esperanza de vida